1,,,,,,,,,,,,,,,
1,3,1,3,,,1,3,6,6,,,2,2,2,5
1,3,1,3,,,1,3,6,6,,,2,2,2,5
1,3,1,3,,,1,3,6,6,,,2,2,2,5
1,3,1,3,1,3,1,3,6,6,6,6,2,2,2,5
1,3,1,3,1,3,1,3,6,6,6,6,2,2,2,5
1,3,1,3,1,3,1,3,6,6,6,6,2,2,2,5
1,3,1,3,1,3,1,3,6,6,6,6,2,2,2,5
1,3,1,3,,,,3,6,,,,2,2,2,2
1,3,1,3,,,,3,6,,,,2,2,2,2
1,3,1,3,,,,3,6,,,,2,2,2,2
1,3,1,3,,,,3,6,,,,2,2,2,2
1,3,1,3,,,,3,6,,,,2,2,2,2
1,3,1,3,,,,3,6,,,,2,2,2,2
1,3,1,3,1,3,1,3,6,6,6,6,2,2,2,4
1,3,1,3,1,3,1,3,6,6,6,6,2,2,2,4
1,3,1,3,1,3,1,3,6,6,6,6,2,2,2,4
1,3,1,3,1,3,1,3,6,6,6,6,2,2,2,4
1,3,1,3,,,1,3,6,6,,,2,2,2,4
1,3,1,3,,,1,3,6,6,,,2,2,2,4
1,3,1,3,,,1,3,6,6,,,2,2,2,4
