1,,,,,,,,,,,,,,,,,,,
3,3,3,3,,,,,,,6,6,,,,,,,,
3,3,3,3,,,,,,6,6,,2,1,,,,,,
3,3,3,3,,6,,,6,6,,2,,1,1,,,,,
3,3,3,,1,6,6,6,6,,2,,2,,1,1,,,,
3,3,,1,1,,6,6,,2,,2,2,5,,1,1,,,
3,,1,1,,1,,,2,,2,2,2,5,1,,1,1,,
,1,1,,1,1,1,,,2,2,2,2,5,1,1,,1,1,
3,1,,1,1,1,,6,4,,2,2,2,1,1,1,1,,1,1
,,1,1,1,,6,6,1,4,,2,2,1,1,1,1,1,,1
,3,1,1,,6,6,,,1,4,,2,1,1,1,1,1,1,1
,,1,1,1,,6,6,1,4,,2,2,1,1,1,1,1,,1
3,1,,1,1,1,,6,4,,2,2,2,1,1,1,1,,1,1
,1,1,,1,1,1,,,2,2,2,2,5,1,1,,1,1,
3,,1,1,,1,,,2,,2,2,2,5,1,,1,1,,
3,3,,1,1,,6,6,,2,,2,2,5,,1,1,,,
3,3,3,,1,6,6,6,6,,2,,2,,1,1,,,,
3,3,3,3,,6,,,6,6,,2,,1,1,,,,,
3,3,3,3,,,,,,6,6,,2,1,,,,,,
3,3,3,3,,,,,,,6,6,,,,,,,,
